#######
#__%__#
#_____#
#_____#
#_____#
#_____#
###_###
###_##########
#_____##_____#
#_____##_____#
#__@______!__#
#_____##_____#
#_____##_____#
##############