#######
#__@__#
#_____#
#_____#
#_____#
#_____#
###_###
###_###
#_____#
#_____#
#_____#
#_____#
#_____#
###_###
###_###
#_____#
#_____#
#_____#
#_____#
#_____#
###_###
###_###
#_____#
#_____#
#_____#
#_____#
#_____#
###_###
###_###
#_____#
#_____#
#_____#
#_____#
#_____#
###_###
###_###
#_____#
#_____#
#_____#
#_____#
#_____#
###_###
###_###
#_____#
#_____#
#_____#
#_____#
#_____#
###_###
###_###
#_____#
#_____#
#_____#
#_____#
#_____#
###_###
###_###
#_____#
#_____#
#_____#
#_____#
#_____#
###_###
###_###
#_____#
#_____#
#_____#
#_____#
#_____#
###_###
###_###
#_____#
#_____#
#_____#
#_____#
#_____#
###_###
